1111111111
1E00001001
10000C0001
1110000111
11000P0111
1111111111