1111111111111
1P000000000E1
1110111111101
1C000000000C1
1110111111101
1C000000000C1
1111111111111