111111111111111111111111111111
1P0000000000000000000000000001
111111011111011111011111011101
1C0000010000010000010000010001
101111101111101111101111101111
1000000000000000000000000000E1
101111111011111011111011111101
1C0000010000010000010000010001
101111101111101111101111101111
100000000000000000000000000001
101111111011111011111011111101
1C0000010000010000010000010001
101111101111101111101111101111
1C00000000000000000000000000C1
111111111111111111111111111111
