111111111
1P0000001
101111111
1C00000E1
111111111