1111111
1E000C1
1110111
1C00001
1011111
1000P01
1111111