1111111111
1C00001001
1E001C0001
1111110011
1P00C00101
1111111111